object Form1: TForm1
  Left = 0
  Top = 0
  AlphaBlendValue = 250
  Caption = 'Form1'
  ClientHeight = 464
  ClientWidth = 753
  Color = clBtnFace
  Font.Charset = DEFAULT_CHARSET
  Font.Color = clWindowText
  Font.Height = -11
  Font.Name = 'Tahoma'
  Font.Style = []
  OldCreateOrder = False
  PixelsPerInch = 96
  TextHeight = 13
  object Panel1: TPanel
    Left = 0
    Top = 0
    Width = 753
    Height = 65
    Align = alTop
    BevelOuter = bvNone
    Color = 6903887
    ParentBackground = False
    TabOrder = 0
    object Image1: TImage
      Left = 0
      Top = 0
      Width = 81
      Height = 59
      Picture.Data = {
        0954506E67496D61676589504E470D0A1A0A0000000D49484452000000460000
        003E0806000000965F6D28000000097048597300000B1300000B1301009A9C18
        000002564944415478DAEDD9CD6A135118C6F1E7CC479BB42AD56E948205172E
        444171E346109715AFC29B71E915B871E34DB81417EE445C15F123DD585BD1B4
        36C94CCE78DE99185BF1594CEA0C243C7FE807A5E999FC3273E60D755B4F3E15
        50D38AA0F173E4BD13CCC90443120C493024C1900443120C493024C190044312
        0C493024C1900443120C493024C1900443120C493024C1905A83B185FC7F58C1
        3920720B04E33D304658A2A816ADFBDCCA833394F025899B97691CC6FEE838A0
        6CAC25D85C4FB1BAE4309E71253B5BF60E726C7FC970302C9044730C6397CF30
        2F70EFEA0AB66E9CC1A5B5185990A9BB98A1D8C7DBDE10CF5FF7D1DBCFD14D5D
        F9B3B985C903C4F58D65DCDEECE0FC4A8C7C96CD6602F3712FC3CBED01BEF673
        A4E1926A6ABF696FF39D3C39FBC6CDBA92AB0EB8446AF260DB8499E29CB2166E
        48D5B16A8EF977ADC39CF6156FEBD56B0DC636DC2CAF7F37FABB38ECB64B895B
        8C3DC616594E816E183CA278B281D6CD559BF628DCE18E4645391B3575AB6E05
        C626DE3C7CBA75B9833B57BAB87036C1D8E6989AAB4551A5F37E778417EF0EB1
        DBF7E1CC690EA771187B65B3CCE3FEB5553CBC69035E5ACE35B561CA39C6E14D
        6F8067AF7EE07398673A61C08B1A9A7E9B7F4B50BE372AB01ECE948BE7E2F2C9
        1856DD4DC27EDDCE8EEF471E3BDFF2F2728AE7F92DC1EF7CD87C73FF67409BED
        68C343C31E95460BB2F9CE638221098624189260488221098624189260488221
        0986241892604882210986241892604882210986241892604882214D611E08E6
        445398BB8F3F08E658067368308F9EEE08E658F6CFD24156F85FCFB8AD6A78ED
        35A40000000049454E44AE426082}
      Stretch = True
    end
    object Label1: TLabel
      Left = 152
      Top = 20
      Width = 161
      Height = 21
      Caption = 'Nova ordem de servi'#231'o'
      Font.Charset = DEFAULT_CHARSET
      Font.Color = 14934239
      Font.Height = -16
      Font.Name = 'Segoe UI'
      Font.Style = []
      ParentFont = False
    end
  end
  object SplitView1: TSplitView
    Left = 0
    Top = 65
    Width = 143
    Height = 399
    Color = 7495766
    OpenedWidth = 155
    Placement = svpLeft
    TabOrder = 1
    object CategoryButtons1: TCategoryButtons
      AlignWithMargins = True
      Left = 0
      Top = 3
      Width = 152
      Height = 158
      Margins.Left = 0
      Align = alCustom
      BevelInner = bvNone
      BevelOuter = bvNone
      BorderStyle = bsNone
      ButtonFlow = cbfVertical
      ButtonWidth = 140
      ButtonOptions = [boFullSize, boGradientFill, boShowCaptions, boVerticalCategoryCaptions]
      Categories = <
        item
          Color = clNone
          Collapsed = False
          Items = <
            item
              Action = acCadastros
            end
            item
              Action = acOrdens
            end
            item
              Caption = 'Movimenta'#231#227'o'
            end>
          TextColor = clNone
        end>
      Color = 7495766
      Font.Charset = DEFAULT_CHARSET
      Font.Color = 14934239
      Font.Height = -13
      Font.Name = 'Segoe UI'
      Font.Style = [fsBold]
      GradientDirection = gdVertical
      HotButtonColor = 14848074
      RegularButtonColor = clNone
      SelectedButtonColor = clNone
      TabOrder = 0
      ExplicitTop = 0
    end
  end
  object Panel2: TPanel
    AlignWithMargins = True
    Left = 546
    Top = 68
    Width = 204
    Height = 393
    Align = alClient
    BevelOuter = bvNone
    Padding.Left = 10
    Padding.Top = 10
    Padding.Right = 10
    Padding.Bottom = 10
    TabOrder = 2
    ExplicitLeft = 158
    ExplicitWidth = 592
    object Panel3: TPanel
      Left = 10
      Top = 10
      Width = 184
      Height = 373
      Align = alClient
      BevelOuter = bvNone
      TabOrder = 0
      ExplicitLeft = 3
      ExplicitTop = 3
      ExplicitWidth = 172
    end
  end
  object SplitView2: TSplitView
    Left = 143
    Top = 65
    Width = 200
    Height = 399
    Color = 11441030
    OpenedWidth = 200
    Placement = svpLeft
    TabOrder = 3
    ExplicitLeft = 158
    ExplicitTop = 71
  end
  object SplitView3: TSplitView
    Left = 343
    Top = 65
    Width = 200
    Height = 399
    Color = 14848074
    OpenedWidth = 200
    Placement = svpLeft
    TabOrder = 4
    ExplicitLeft = 163
  end
  object ImageList1: TImageList
    Left = 502
    Top = 198
    Bitmap = {
      494C010101000800040010001000FFFFFFFFFF10FFFFFFFFFFFFFFFF424D3600
      0000000000003600000028000000400000001000000001002000000000000010
      0000000000000000000000000000000000000000000000000000000000000000
      0000000000000000000000000000000000000000000000000000000000000000
      0000000000000000000000000000000000000000000000000000000000000000
      0000000000000000000000000000000000000000000000000000000000000000
      0000000000000000000000000000000000000000000000000000000000000000
      0000000000000000000000000000000000000000000000000000000000000000
      0000000000000000000000000000000000000000000000000000000000000000
      0000000000000000000000000000000000000000000000000000000000000000
      000000000000000000000000000000000000000000AE000000A5000000150000
      00000000000000000000000000000000001C000000750000001C000000000000
      0000000000000000000000000065000000A60000000000000000000000000000
      0000000000000000000000000000000000000000000000000000000000000000
      0000000000000000000000000000000000000000000000000000000000000000
      0000000000000000000000000000000000000000000000000000000000000000
      0000000000000000000000000000000000000000000000000000000000000000
      0000000000000000000000000000000000000000000000000000000000000000
      000000000000000000000000000000000000000000E4000000AF000000870000
      00430000008E000000A8000000680000007C0000005F0000007C0000009E0000
      00A80000005B00000043000000C8000000AF0000000000000000000000000000
      0000000000000000000000000000000000000000000000000000000000000000
      0000000000000000000000000000000000000000000000000000000000000000
      0000000000000000000000000000000000000000000000000000000000000000
      0000000000000000000000000000000000000000000000000000000000000000
      0000000000000000000000000000000000000000000000000000000000000000
      000000000000000000000000000000000000000000C500000000000000480000
      0099000000AB00000090000000C90000007D000000420000007E000000990000
      0090000000CC0000009900000006000000000000000000000000000000000000
      0000000000000000000000000000000000000000000000000000000000000000
      0000000000000000000000000000000000000000000000000000000000000000
      0000000000000000000000000000000000000000000000000000000000000000
      0000000000000000000000000000000000000000000000000000000000000000
      0000000000000000000000000000000000000000000000000000000000000000
      000000000000000000000000000000000000000000C500000000000000000000
      0000000000000000000000000000000000000000006300000000000000000000
      0000000000000000000000000000000000000000000000000000000000000000
      0000000000000000000000000000000000000000000000000000000000000000
      0000000000000000000000000000000000000000000000000000000000000000
      0000000000000000000000000000000000000000000000000000000000000000
      0000000000000000000000000000000000000000000000000000000000000000
      0000000000000000000000000000000000000000000000000000000000000000
      000000000000000000000000000000000000000000C500000000000000000000
      0000000000000000000000000000000000000000006300000000000000000000
      0000000000000000000000000000000000000000000000000000000000000000
      0000000000000000000000000000000000000000000000000000000000000000
      0000000000000000000000000000000000000000000000000000000000000000
      0000000000000000000000000000000000000000000000000000000000000000
      0000000000000000000000000000000000000000000000000000000000000000
      0000000000000000000000000000000000000000000000000000000000000000
      000000000000000000000000000000000000000000C500000000000000000000
      0000000000000000000000000000000000000000006300000000000000000000
      0000000000000000000000000000000000000000000000000000000000000000
      0000000000000000000000000000000000000000000000000000000000000000
      0000000000000000000000000000000000000000000000000000000000000000
      0000000000000000000000000000000000000000000000000000000000000000
      0000000000000000000000000000000000000000000000000000000000000000
      0000000000000000000000000000000000000000000000000000000000000000
      000000000000000000000000000000000000000000C500000000000000000000
      0000000000000000000000000000000000000000006300000000000000000000
      0000000000000000000000000000000000000000000000000000000000000000
      0000000000000000000000000000000000000000000000000000000000000000
      0000000000000000000000000000000000000000000000000000000000000000
      0000000000000000000000000000000000000000000000000000000000000000
      0000000000000000000000000000000000000000000000000000000000000000
      0000000000000000000000000000000000000000000000000000000000000000
      000000000000000000000000000000000000000000C500000000000000000000
      0000000000000000000000000000000000000000006300000000000000000000
      0000000000000000000000000000000000000000000000000000000000000000
      0000000000000000000000000000000000000000000000000000000000000000
      0000000000000000000000000000000000000000000000000000000000000000
      0000000000000000000000000000000000000000000000000000000000000000
      0000000000000000000000000000000000000000000000000000000000000000
      0000000000000000000000000000000000000000000000000000000000000000
      000000000000000000000000000000000000000000C500000000000000000000
      0000000000000000000000000000000000000000006300000000000000000000
      0000000000000000000000000000000000000000000000000000000000000000
      0000000000000000000000000000000000000000000000000000000000000000
      0000000000000000000000000000000000000000000000000000000000000000
      0000000000000000000000000000000000000000000000000000000000000000
      0000000000000000000000000000000000000000000000000000000000000000
      0000000000000000000000000000000000000000000000000000000000000000
      000000000000000000000000000000000000000000C500000000000000000000
      0000000000000000000000000000000000000000006300000000000000000000
      0000000000000000000000000000000000000000000000000000000000000000
      0000000000000000000000000000000000000000000000000000000000000000
      0000000000000000000000000000000000000000000000000000000000000000
      0000000000000000000000000000000000000000000000000000000000000000
      0000000000000000000000000000000000000000000000000000000000000000
      0000000000000000000000000000000000000000000000000000000000000000
      000000000000000000000000000000000000000000C500000000000000000000
      0000000000000000000000000000000000000000002C00000000000000000000
      0000000000000000000000000000000000000000000000000000000000000000
      0000000000000000000000000000000000000000000000000000000000000000
      0000000000000000000000000000000000000000000000000000000000000000
      0000000000000000000000000000000000000000000000000000000000000000
      0000000000000000000000000000000000000000000000000000000000000000
      0000000000000000000000000000000000000000000000000000000000000000
      000000000000000000000000000000000000000000E600000083000000030000
      00000000000000000000000000000000000E000000CC0000000E000000000000
      0000000000000000000000000043000000830000000000000000000000000000
      0000000000000000000000000000000000000000000000000000000000000000
      0000000000000000000000000000000000000000000000000000000000000000
      0000000000000000000000000000000000000000000000000000000000000000
      0000000000000000000000000000000000000000000000000000000000000000
      0000000000000000000000000000000000000000000000000000000000000000
      0000000000000000000000000000000000000000001900000047000000CB0000
      009D000000140000000000000046000000C600000048000000C6000000050000
      00000000004E0000009D0000008E000000470000000000000000000000000000
      0000000000000000000000000000000000000000000000000000000000000000
      0000000000000000000000000000000000000000000000000000000000000000
      0000000000000000000000000000000000000000000000000000000000000000
      0000000000000000000000000000000000000000000000000000000000000000
      0000000000000000000000000000000000000000000000000000000000000000
      0000000000000000000000000000000000000000000000000000000000000000
      0000000000000000000000000000000000000000000000000000000000000000
      0000000000000000000000000000000000000000000000000000000000000000
      0000000000000000000000000000000000000000000000000000000000000000
      0000000000000000000000000000000000000000000000000000000000000000
      0000000000000000000000000000000000000000000000000000000000000000
      0000000000000000000000000000000000000000000000000000000000000000
      0000000000000000000000000000000000000000000000000000000000000000
      0000000000000000000000000000000000000000000000000000000000000000
      0000000000000000000000000000000000000000000000000000000000000000
      0000000000000000000000000000000000000000000000000000000000000000
      0000000000000000000000000000000000000000000000000000000000000000
      0000000000000000000000000000000000000000000000000000000000000000
      0000000000000000000000000000000000000000000000000000000000000000
      0000000000000000000000000000000000000000000000000000000000000000
      0000000000000000000000000000000000000000000000000000000000000000
      000000000000000000000000000000000000424D3E000000000000003E000000
      2800000040000000100000000100010000000000800000000000000000000000
      000000000000000000000000FFFFFF0000000000000000000000000000000000
      0000000000000000000000000000000000000000000000000000000000000000
      0000000000000000000000000000000000000000000000000000000000000000
      0000000000000000000000000000000000000000000000000000000000000000
      0000000000000000000000000000000000000000000000000000000000000000
      000000000000}
  end
  object ActionList1: TActionList
    Left = 384
    Top = 126
    object acCadastros: TAction
      Caption = 'Cadastros'
      OnExecute = acCadastrosExecute
    end
    object acOrdens: TAction
      Caption = 'Ordens'
      OnExecute = acOrdensExecute
    end
  end
end
